40 40
2 2 2 2 2 2 2 2 2 2 2 2 2 2 2 2 2 2 2 2 2 2 2 2 2 2 2 2 2 2 2 2 2 2 2 2 2 2 2 2 
2 0 0 0 2 2 0 0 0 0 0 5 0 2 2 2 0 0 0 0 0 0 0 2 0 0 0 0 0 0 0 2 0 0 0 0 0 0 2 2
2 0 0 0 2 2 0 0 6 0 0 5 0 2 2 2 0 0 0 0 6 0 0 2 0 0 6 0 2 0 0 2 0 0 0 0 5 0 2 2
2 0 0 0 0 0 0 0 0 0 0 0 0 2 2 2 0 0 0 0 0 0 0 2 2 2 0 0 2 0 0 2 0 0 0 10 0 0 2 2
2 0 0 0 0 5 0 6 0 0 0 0 0 0 0 6 0 0 0 5 0 0 0 6 0 0 0 0 2 0 0 0 0 6 0 0 0 0 2 2
2 2 6 2 2 0 0 0 0 0 0 0 0 0 0 5 0 0 0 0 0 0 0 0 0 0 0 0 2 0 0 2 0 0 0 0 0 0 2 2
2 2 6 2 2 0 2 2 2 0 5 0 0 5 0 0 0 6 0 0 0 0 2 2 2 2 0 0 2 0 0 2 0 0 2 2 0 2 2 2
2 0 0 0 0 0 0 0 0 6 0 0 0 0 0 0 0 0 0 0 0 0 2 0 0 0 0 0 2 0 0 0 5 0 0 0 0 0 2 2
2 0 0 0 6 0 0 0 0 0 0 0 0 6 0 0 0 0 0 5 0 0 2 0 0 6 0 0 2 0 0 0 0 0 0 5 0 0 2 2
2 0 0 0 0 0 0 6 0 0 0 0 0 0 0 0 2 0 0 0 0 0 2 0 0 0 0 0 2 0 0 0 0 0 0 0 0 0 2 2
2 0 0 5 0 0 0 0 0 0 0 6 0 0 0 0 2 0 0 0 0 0 0 0 0 0 0 0 2 0 0 5 0 0 0 6 0 0 2 2
2 0 10 0 0 0 0 10 0 0 0 6 0 0 0 10 2 2 2 2 0 0 0 0 0 6 6 0 2 0 0 0 0 0 0 0 0 0 2 2
2 0 0 0 0 0 0 0 0 0 0 6 0 0 0 0 0 0 0 2 0 0 0 0 5 5 0 0 2 0 5 0 0 0 0 0 5 5 2 2
2 2 2 2 2 0 0 6 0 0 0 0 0 0 0 5 0 0 0 2 0 0 0 0 5 5 0 0 2 0 0 0 0 6 0 0 0 0 2 2
2 0 0 0 0 0 0 5 0 0 0 0 0 0 0 5 0 0 0 2 0 6 0 0 0 0 0 0 10 0 0 0 0 0 0 0 0 0 2 2
2 0 0 0 0 0 0 0 0 0 0 10 0 0 0 0 0 0 0 2 0 0 0 0 6 0 0 0 2 0 0 0 6 0 0 0 0 0 2 2
2 0 0 6 0 0 0 0 0 0 0 0 0 0 0 0 0 0 0 2 0 0 0 0 0 0 0 0 2 0 5 0 0 0 0 0 0 0 2 2
2 0 0 0 0 0 0 0 0 0 5 0 0 0 0 6 0 0 0 2 0 0 0 0 0 0 0 0 2 0 0 0 0 0 6 0 0 0 2 2
2 0 0 0 0 0 10 0 0 0 0 0 0 0 0 0 0 0 10 0 0 0 0 0 0 0 0 0 2 0 0 0 0 0 0 0 0 10 2 2
2 2 2 2 2 0 2 2 2 2 2 0 0 2 2 2 2 2 2 2 2 2 0 0 2 2 2 2 2 2 2 6 2 2 2 0 2 2 2 2
2 2 2 2 2 0 2 2 2 2 2 0 0 2 2 2 2 2 2 2 2 2 0 0 2 2 2 2 2 2 2 0 2 2 2 0 2 2 2 2 
2 0 0 0 0 0 0 0 0 2 0 0 0 0 0 0 0 0 0 0 0 0 0 0 10 0 0 0 0 0 0 0 0 0 0 0 0 2 2 2
2 0 5 0 0 0 0 0 0 2 0 0 0 0 0 0 0 0 0 2 0 0 0 0 0 0 0 0 2 6 0 0 0 0 0 0 0 0 2 2
2 0 5 0 0 0 0 0 0 2 0 10 0 0 0 0 0 0 0 2 0 0 0 0 0 0 0 0 2 0 0 0 0 0 0 0 0 0 2 2
2 0 0 0 0 0 0 0 0 2 0 0 6 0 0 0 0 0 0 2 0 0 0 0 0 0 0 0 2 0 0 6 0 0 0 0 10 0 2 2
2 2 2 2 2 0 0 0 0 2 0 0 0 0 5 0 0 0 0 2 0 0 0 6 0 0 0 0 2 0 0 0 0 0 0 0 0 0 2 2
2 2 2 2 2 0 0 0 0 2 0 0 0 0 0 0 0 0 0 2 0 0 0 0 0 0 0 0 2 0 0 0 0 5 0 0 0 0 2 2
2 0 0 0 0 0 0 0 0 0 0 0 0 0 5 0 0 0 0 2 0 0 0 0 0 6 0 0 2 5 0 0 0 0 0 0 0 0 2 2
2 0 0 5 5 0 0 0 0 0 0 0 10 0 0 0 0 0 0 2 0 0 0 0 0 0 0 0 2 0 0 0 0 0 0 0 0 0 2 2
2 0 0 0 0 0 0 0 0 0 0 2 2 0 5 6 0 0 0 2 0 0 0 6 0 0 0 0 2 0 0 0 0 0 10 0 0 0 2 2
2 0 0 0 0 0 10 0 0 0 0 0 0 0 0 0 0 0 0 2 0 6 6 6 0 0 0 0 2 0 0 0 0 0 0 0 0 0 2 2
2 0 0 0 0 0 0 0 0 0 6 0 0 0 0 0 0 0 0 2 0 0 0 0 0 0 0 0 2 0 0 6 0 0 0 0 0 0 2 2
2 2 0 2 2 0 0 0 0 0 0 0 0 0 5 5 0 0 0 2 0 0 0 0 0 0 0 0 2 0 0 0 0 0 0 0 0 0 2 2
2 2 0 2 2 0 0 0 0 0 0 0 0 0 5 5 0 0 0 2 0 0 5 0 0 0 0 0 2 2 2 2 2 2 2 2 2 2 2 2
2 0 0 0 0 5 0 0 0 0 0 0 6 0 0 0 0 0 0 2 0 0 5 0 0 0 0 0 6 0 0 0 0 0 0 0 0 0 2 2
2 0 5 0 0 0 0 0 0 6 0 0 0 0 0 0 0 0 0 2 0 0 0 0 0 6 0 0 6 0 0 0 0 0 5 0 0 0 2 2
2 0 5 0 0 10 0 0 0 0 0 0 0 0 0 0 0 0 0 2 0 0 0 0 0 0 0 0 0 0 0 0 0 0 0 0 10 0 2 2
2 0 0 0 0 0 0 0 0 0 6 0 0 0 0 5 0 0 0 2 0 0 0 5 0 0 0 0 2 0 0 0 0 0 0 0 0 0 2 2
2 0 0 0 0 0 0 0 0 0 0 0 0 0 0 0 0 0 0 0 0 0 0 0 0 0 0 0 2 0 0 0 0 0 0 0 10 50 2 2
2 2 2 2 2 2 2 2 2 2 2 2 2 2 2 2 2 2 2 2 2 2 2 2 2 2 2 2 2 2 2 2 2 2 2 2 2 2 2 2
