40 40
2 2 2 2 2 2 2 2 2 2 2 2 2 2 2 2 2 2 2 2 2 2 2 2 2 2 2 2 2 2 2 2 2 2 2 2 2 2 2 2 
2 0 0 0 0 0 2 0 0 0 0 0 0 0 2 0 0 0 0 0 0 0 10 0 0 0 0 0 0 0 0 0 0 0 11 0 0 0 2 2
2 100 0 6 0 0 2 0 0 6 0 5 0 0 2 0 0 0 0 2 0 0 0 0 0 0 0 0 2 6 0 0 0 5 5 0 0 0 2 2
2 0 0 0 6 0 2 0 0 6 0 0 0 10 0 0 6 0 0 2 0 0 5 0 0 5 0 0 2 0 0 5 0 0 0 5 0 0 2 2
2 5 0 0 0 0 2 0 0 0 5 0 0 0 0 5 0 0 0 2 0 0 0 0 11 0 0 0 2 6 0 0 0 0 0 5 0 0 2 2
2 0 0 0 0 0 10 0 0 5 0 0 6 0 0 0 0 0 0 2 0 0 0 0 0 0 0 0 2 0 0 10 0 0 0 0 0 0 2 2
2 2 2 2 2 0 0 0 0 0 0 5 5 0 0 6 0 0 0 2 0 5 5 0 0 0 0 0 2 0 0 0 0 10 0 0 0 0 2 2
2 0 0 0 0 0 6 0 0 0 0 0 0 0 0 6 0 0 0 2 0 0 0 0 0 10 0 0 2 0 2 2 2 2 2 2 2 0 2 2
2 0 5 5 0 0 0 0 6 0 0 0 6 0 0 0 0 0 0 2 0 0 0 5 0 0 0 0 2 0 0 0 0 0 0 5 0 0 2 2
2 0 0 0 0 11 0 0 0 6 0 0 0 0 0 0 0 0 0 0 0 0 0 6 0 0 6 0 2 0 0 11 0 0 6 0 0 0 2 2
2 0 10 0 0 0 0 0 0 0 11 0 0 0 6 6 6 6 0 2 0 10 0 0 0 0 0 0 0 5 0 0 0 0 0 0 0 0 2 2
2 0 0 0 0 0 0 0 0 6 0 0 0 0 0 0 0 0 0 2 6 0 0 5 0 0 0 0 2 0 0 5 5 0 0 0 0 0 2 2
2 0 2 2 2 0 0 6 0 0 0 0 0 0 10 0 0 0 0 2 6 0 0 0 0 0 0 0 2 0 0 5 5 0 0 5 0 0 2 2
2 0 2 2 2 0 0 0 0 0 0 5 0 0 0 0 0 0 0 2 0 0 0 6 0 0 0 0 2 0 0 0 0 0 0 0 0 0 2 2
2 0 0 0 0 0 0 6 0 0 0 0 0 0 5 0 0 11 0 2 0 10 0 0 2 2 2 2 2 0 0 0 0 0 10 0 6 0 2 2
2 10 0 0 0 0 0 0 0 10 0 0 0 0 0 0 0 0 0 2 0 5 0 0 6 0 0 0 2 0 0 5 0 0 0 0 0 0 2 2
2 0 0 5 5 5 5 0 0 0 0 0 0 5 0 0 5 0 0 2 0 0 10 0 0 0 0 0 2 0 0 0 0 10 0 0 0 0 2 2
2 0 0 0 0 0 0 0 6 0 10 0 0 0 10 0 0 0 0 2 0 0 0 10 0 0 0 0 2 0 0 11 0 0 0 6 0 0 2 2
2 2 2 2 2 0 0 0 0 0 0 0 0 5 0 0 0 0 0 0 0 0 10 0 0 0 0 0 2 0 0 0 0 0 0 0 0 0 2 2
2 2 2 2 2 0 2 2 2 2 2 2 2 2 2 2 2 2 2 2 2 2 2 2 6 2 2 2 2 2 2 2 2 2 2 2 2 0 2 2
2 2 2 2 2 0 2 2 2 2 2 2 2 2 2 2 2 2 2 2 2 2 2 2 0 2 2 2 2 2 2 2 2 2 2 2 2 0 2 2 
2 0 0 0 0 0 0 0 0 2 0 0 0 6 6 0 0 0 0 0 0 0 0 0 6 0 0 0 0 0 0 5 5 0 0 0 0 0 2 2
2 0 0 5 0 0 0 0 0 2 0 0 0 0 0 0 0 0 0 2 0 0 6 6 0 0 5 0 2 0 0 5 5 0 0 0 0 0 2 2
2 0 0 5 0 5 0 0 0 2 5 0 6 0 0 5 5 5 0 2 0 0 5 0 0 0 0 0 2 0 0 0 0 0 0 10 0 0 2 2
2 0 0 0 0 0 0 6 0 2 0 0 0 0 0 0 0 0 0 2 0 0 0 0 0 0 0 0 2 0 0 0 6 0 0 0 0 0 2 2
2 2 2 2 2 0 0 0 0 2 0 0 6 0 0 11 0 0 0 2 0 0 0 6 0 0 5 0 2 0 0 0 0 0 0 0 0 0 2 2
2 2 2 2 2 0 0 11 0 2 0 0 0 0 0 5 5 0 0 2 0 0 0 0 0 0 0 0 2 0 0 0 0 5 0 0 0 0 2 2
2 0 0 0 0 0 0 0 0 0 0 0 0 0 0 0 0 0 0 2 0 0 0 0 11 0 0 0 2 0 0 10 0 0 0 0 0 0 2 2
2 0 10 0 0 0 0 0 5 0 5 0 0 6 0 0 0 0 0 2 0 6 0 0 0 0 0 0 2 0 0 0 0 6 6 6 6 6 2 2
2 0 0 6 6 6 6 0 0 0 0 0 0 0 0 0 10 0 0 2 0 0 0 0 0 0 0 0 2 0 5 0 0 0 0 0 0 0 2 2
2 0 0 0 0 0 0 0 0 0 10 0 0 0 10 0 0 0 0 2 0 0 0 10 0 0 0 0 2 0 0 0 0 0 0 0 0 0 2 2
2 5 0 0 10 0 0 6 0 0 0 0 0 0 0 0 0 0 0 2 0 0 0 0 0 0 0 0 2 0 5 0 0 0 0 0 6 0 2 2
2 0 0 0 0 0 0 0 0 0 2 0 2 2 2 0 2 2 0 2 0 0 0 0 0 0 0 0 2 0 0 0 0 0 10 0 0 0 2 2
2 0 0 0 0 0 5 0 0 6 2 0 0 0 0 0 10 0 0 2 0 11 0 0 6 6 0 0 2 2 2 2 2 2 2 2 2 2 2 2
2 0 5 0 11 0 0 0 0 0 5 6 0 0 0 0 0 0 0 2 0 0 0 0 0 0 0 0 0 0 0 0 0 0 0 0 0 0 2 2
2 0 0 0 0 0 0 0 0 0 5 0 0 0 0 0 6 0 0 2 0 0 0 6 0 0 0 0 2 0 0 0 10 0 0 0 5 0 2 2
2 0 6 6 0 0 0 0 10 0 0 0 0 0 0 0 0 0 0 2 0 5 0 0 0 0 0 0 6 6 0 0 0 0 0 0 0 0 2 2
2 0 0 0 0 5 0 0 0 0 2 0 0 5 0 0 10 0 0 2 0 0 0 0 6 0 0 0 0 0 0 0 0 0 0 0 0 50 2 2
2 0 0 0 0 0 0 0 0 0 2 0 10 0 0 0 0 0 0 0 0 0 10 0 0 0 0 0 2 0 0 0 0 0 0 11 0 0 2 2
2 2 2 2 2 2 2 2 2 2 2 2 2 2 2 2 2 2 2 2 2 2 2 2 2 2 2 2 2 2 2 2 2 2 2 2 2 2 2 2